WWWWWWWWWWWWWWWWWWW
W.................W
W.................W
W.................W
W.................W
W.................W
W.................W
W.................W
..................W
......... ........W
..................W
W.........T.......W
W.................W
W.................W
W.................W
W.................W
W.................W
W.................W
WWWWWWWWWWWWWWWWWWW