WWWWWWWWWWWWWWWWWWW
W.................W
W.................W
W.................W
W.................W
W.................W
W.................W
W.................W
|S................|
|S................|
|S................|
W.................W
W.................W
W.................W
W.................W
W.................W
W.................W
W.................W
WWWWWWWWWWWWWWWWWWW