WWWWWWWWWWWWW
W...........W
W...........W
W...........W
W...........W
W...........W
W.....P.....W
W...........W
W...........W
W...........W
W...........W
W...........W
WWWWWWWWWWWWW