WWWWWWWWWWWWWWWWWWW
W.................W
W.................W
W.................W
W.................W
W.................W
W.................W
WSS...............W
|.S...............|
|.S...............|
|.S...............|
WSS...............W
W.................W
W.................W
W.................W
W.................W
W.................W
W.................W
WWWWWWWWWWWWWWWWWWW